20 20
####################
#  a  a  #         #
# a   a  #    #    #
#  # #   b    #    #
# # # #            #
# # a #  b    #    #
#  # #   #   # #   #
#   #    #  #####  #
# b   a  # #     # #
#######      #######
#######      #######
#                  #
#      bbbbb       #
#      b       b   #
#      bbbbb  bbb  #
#          b   b   #
#      bbbbb       #
#                  #
#                  #
####################