10 20
####################
#  a  a  #         #
# a   a  #    #    #
#  # #   b    #    #
# # # #            #
# # a #  b    #    #
#  # #   #   # #   #
#   #       #####  #
# b   a  # #     # #
####################