10 10
##########
#  a  a  #
# a   a  #
#  # ### #
#  # #   #
#  ##### #
#    # # #
#  ### # #
# b  bab #
##########