10 20
####################
#  a  a            #
# a   a       #    #
#  # #        # a  #
# # # # b   a      #
# # a #   a   #    #
#  # #  b    # #   #
#   #       #####  #
# b   a b b b a  # #
####################